50

2  2  2  2  2  2  2  2  2  2  2  2  2  2  2  2  2
3  3  3  3  2  2  2  2  2  2  2  2  2  2  2  2  2
2  2  2  3  2  2  2  2  2  2  2  2  2  2  2  2  2
2  2  2  3  2  2  2  2  2  2  2  3  3  3  3  3  3
2  2  2  3  3  3  3  2  2  2  2  3  2  2  2  2  2
2  2  2  2  2  2  3  2  2  2  2  3  2  2  2  2  2
2  2  2  2  2  2  3  2  2  2  2  3  2  2  2  2  2
2  2  2  2  2  2  3  3  3  3  3  3  2  2  2  2  2
2  2  2  2  2  2  2  2  2  2  2  2  2  2  2  2  2
2  2  2  2  2  2  2  2  2  2  2  2  2  2  2  2  2
2  2  2  2  2  2  2  2  2  2  2  2  2  2  2  2  2

-1 -1 -1 -1 -1  7  7  7  7  7  7  6  6  6  6  6  6
-1 -1 -1 -1 -1 18 14 20 30 16 28 22 -1 11 11 11 11
-1 -1 -1 -1 -1 29 29 29 29 29 29 -1 -1 -1 -1 -1 -1
-1 -1 -1 -1 -1 -1 -1 -1 -1 -1 -1 -1 -1 -1 -1 -1  0
-1 -1 -1 -1 -1 -1 -1 -1 -1 -1 -1 -1 -1 -1 -1 -1 -1
-1 19 26 -1 -1 -1 -1 -1 -1 -1 -1 -1 -1 -1 30 27 30
-1 -1 -1 -1 -1 -1 -1 -1 -1 -1 -1 -1 -1 13 30 30 30
30 30 30 30 -1 22 -1 -1 -1 -1 -1 -1 -1 23  7 20 -1
30 30 30 30 -1 -1 -1 -1 -1 -1 -1 -1 -1 -1 -1 -1 -1
30 30 30 30 -1 -1 -1 -1 -1 -1 -1 -1 -1 -1 -1 -1 -1
-1 -1 -1 -1 20 19 23 -1 -1 -1 -1 -1 13 16 21 -1 -1