60

4  4  4  4  4  4  4  4  4  4  4  4  4  4  4  4  4
5  5  5  5  4  4  5  5  5  5  5  5  4  4  4  4  4
4  4  4  5  4  4  5  4  4  4  4  5  4  4  4  4  4
4  4  4  5  4  4  5  5  4  4  4  5  4  4  4  4  4
4  4  4  5  4  4  4  5  4  4  4  5  4  4  4  4  4
4  4  4  5  5  5  5  5  4  4  4  5  4  4  4  4  4
4  4  4  4  4  4  4  4  4  4  4  5  4  4  4  4  4
4  4  4  4  4  4  4  4  4  4  4  5  5  5  5  5  5
4  4  4  4  4  4  4  4  4  4  4  4  4  4  4  4  4
4  4  4  4  4  4  4  4  4  4  4  4  4  4  4  4  4
4  4  4  4  4  4  4  4  4  4  4  4  4  4  4  4  4

-1 -1 -1 26  8 -1 -1 -1 -1 12 12 -1 -1 27 -1 25 -1
-1 -1 -1 -1 -1 -1 -1 -1 -1 -1 -1 -1 -1 -1 -1 -1 -1
-1 -1 -1 -1 -1 -1 -1 -1 -1 -1 -1 -1 -1 17 18 12  7
11 11 -1 -1 -1 -1 -1 -1 -1 -1 22 -1 -1 -1 -1 -1 -1
11 11 -1 -1 -1 -1 -1 -1 20 23 -1 -1 -1 12 27 20 12
-1 -1 -1 -1 -1 -1 -1 -1 -1 -1 -1 -1 -1 -1 -1 12 -1
-1 -1 -1 -1 -1 -1 -1 -1 -1  6 16 -1 -1 -1 -1 -1 -1
 7  7 -1 30 30 30 -1 -1 -1 -1 -1 -1 -1 -1 -1 -1  0
-1 -1 29 29 29 29 29 -1 -1 -1 -1 -1 -1 11 12 -1 -1
-1 -1 18 30 19 20 21 -1 13 13 -1 -1 16 23 19  6 -1
 8  8  8  8  8  8  8  8  8  8  9  9  9  9  9  9  9
