70

6  6  6  6  6  6  6  6  6  6  6  6  6  6  6  6  6
6  6  6  6  6  6  6  6  6  6  6  6  6  6  6  6  6
6  6  6  6  6  6  6  6  6  6  6  6  6  6  6  6  6
6  6  6  6  6  6  6  6  6  6  6  6  6  6  6  6  6
7  7  7  6  6  6  6  6  6  6  6  6  6  6  6  6  6
6  6  7  6  6  6  6  6  7  7  7  7  7  7  6  6  6
6  6  7  7  7  6  6  6  7  6  6  6  6  7  6  6  6
6  6  6  6  7  6  6  6  7  6  6  6  6  5  5  5  5
6  6  6  6  7  7  7  7  7  6  6  6  6  6  6  6  6
6  6  6  6  6  6  6  6  6  6  6  6  6  6  6  6  6
6  6  6  6  6  6  6  6  6  6  6  6  6  6  6  6  6




10 10 10 10 10 10 10  5  5  5 21  6  6  6  7 25 -1
-1 24 10 27 -1 18 14 20 13 16 28 22 -1 11 11 11 11
26 18 19 -1 -1 29 29 29 29 29 29 29 -1 -1 -1 -1 -1
-1 -1 -1 -1 -1 -1 10 27 24 -1 -1 -1 -1 -1 26 20 -1
-1 -1 -1 -1 -1 -1 -1 -1 -1 -1 -1 -1 -1 -1 -1 -1 -1
-1 19 -1 -1 -1 -1 24 -1 -1 -1 -1 -1 -1 -1 -1 -1 -1
-1 -1 -1 -1 -1 -1 -1 22 -1 -1 -1 -1 -1 -1 -1 10 -1
-1 -1 -1 -1 -1 -1 -1 -1 -1 -1 24 10 -1 -1 -1 -1  0
11 11 11 11 -1 -1 -1 -1 -1 -1 19 10 -1 -1 -1 -1 -1
12 12 12 12 -1 -1 -1 -1 -1 -1 -1 -1 -1 -1 -1 -1 -1
-1 -1 -1 -1 20 11 19  6 -1 30 30 30 -1 13 16 21 -1
